##############################################################
#               #           #   # #   #   #       #      #   #
# ############# # ######### # # # # # # ### ##### ###### # # #
#   # #   #   # #         # # # #   #   #   #   #      #   # #
### # # # # # # ####### ### ### # ####### ### # ##   # ##### #
#   #   # # # #   # #   #   #           #     # #    # #F    #
# ### ### ### ### # # ### ### ######### ####### #    # # #####
#F  # #     # #     # #   #   # #   #   # #     #    #       #
# # # ##### # ####### # ### ### # # # # #   ######   ### ### #
# #   #   # # #   #   # #       # #   # # #          #     # #
# ##### # # # # # ### # ######### ####### ################## #
# #     # # # # # #   #           #        #               # #
# # ##### # # # ### ############ ######### # ###### ###### ###
# #   #   # # # #    #   #   # #       # # #      #      #   #
# # # # ### ### #  ### # # # # ####### # # # ## # ###### ### #
#   ### #       #    # # # # #       #   # #  # # #    # #   #
#####   # ##### ###  # ### # ##### ### # #    # ###  # ### ###
#     ###   # #        #   # #   #     # # ####   #  #   #   #
# ### #   # # # ###### # ### ### ####### #      # #  #   ### #
# #   #   # # # #    #   #   # #     # # ### ####    #     # #
# # ####### #   ###  # # # ### # #####   # # #  ##########   #
# #         # #      # # #   # #     #   # # #             # #
# ###################### ### # # # # ### #   #  ######## # # #
#   #     #   # #        #           #    ##### ##############
##### #         # #  #   #   #     #  # #     #           #  #
#    F######### # # ######## #    ### # # ### # ######### # ##
# #####       # # #      #   #### #   # # #   # #       # #  #
# #   #  #### # # #  ### #      # # ##### # #####  ### ## # ##
#   #         #          #        #       #                  F
##############################################################